Game,Team,Opponent,TeamPoints,OpponentPoints,PointDifference,Winner
1,ATL,TOR,102,109,-7,TOR
2,ATL,IND,102,92,10,ATL
3,ATL,SAS,92,94,-2,SAS
4,ATL,CHO,119,122,-3,CHO
5,ATL,NYK,103,96,7,ATL
6,ATL,NYK,91,85,6,ATL
7,ATL,UTA,100,97,3,ATL
8,ATL,MIA,114,103,11,ATL
9,ATL,CLE,94,127,-33,CLE
10,ATL,LAL,109,114,-5,LAL
